[
  [
    [".", ".", "#", "#", "#", ".", ".", "."],
    [".", ".", "#", "T", "#", ".", ".", "."],
    [".", ".", "#", ".", "#", "#", "#", "#"],
    ["#", "#", "#", "B", ".", "B", "T", "#"],
    ["#", "T", "B", ".", "P", "#", "#", "#"],
    ["#", "#", "#", "#", "B", "#", ".", "."],
    [".", ".", ".", "#", "T", "#", ".", "."],
    [".", ".", ".", "#", "#", "#", ".", "."]
  ]
]